{
  "width": 16,
  "height": 12,
  "mapTiles": [
    [1,1,1,1,1,1,1,1,1,1,1,1,1,1,1,1],
    [1,0,0,0,0,0,0,1,0,0,0,0,0,0,0,1],
    [1,0,1,1,1,0,0,1,0,1,1,1,1,0,0,1],
    [1,0,1,0,1,0,0,1,0,1,0,0,1,0,0,1],
    [1,0,1,0,1,1,1,1,0,1,0,1,1,1,0,1],
    [1,0,0,0,0,0,0,0,0,1,0,0,0,1,0,1],
    [1,1,1,0,1,1,1,1,1,1,1,1,0,1,0,1],
    [1,0,0,0,1,0,0,0,0,0,0,1,0,1,0,1],
    [1,0,1,1,1,0,1,1,1,1,0,1,0,1,0,1],
    [1,0,0,0,0,0,0,0,0,0,0,1,0,0,0,1],
    [1,1,1,1,1,1,1,1,1,1,1,1,1,1,1,1],
    [1,1,1,1,1,1,1,1,1,1,1,1,1,1,1,1]
  ]
}
